111111111
1E0000001
1PC00EC11
111111111