1111111111
1000000E11
1000C00001
1P11110001
1111111111