111111111
1E0000C01
1PC000C01
111111111