111111111
1E0000C01
1PC000101
111111111