111111111
100000001
1PC00EC11
111111111