1111111111
10C000E011
1000C00001
1P11100001
1111111111