111111111
100000C01
1PC00EC01
111111111