1111111111
1E0000C0E1
1PC000CC01
1C1ECC0011
1111111111