11111111111111
1000000ECC00C1
1000C00000E111
1P1111000CCCC1
11111111111111