1111111111
10000P00111
1000000001
1P11100001
1111111111
1